##############################
#........###.................#
#........#......##..........##
#........#..................##
#@.s.........................#
#........#..................##
#........#......##..........##
##############################
